"id","court_cp","court_mp","QTL1","QTL17","QTL18","total_court","geno1","geno17","geno18"
13047,12,0,1,1,1,12,"A","A","A"
13049,13,3,1,2,1,16,"A","B","A"
13050,13,12,1,1,2,25,"A","A","B"
13051,5,1,2,1,1,6,"B","A","A"
13057,2,2,2,1,1,4,"B","A","A"
13149,0,0,2,2,2,0,"B","B","B"
13170,8,0,1,1,1,8,"A","A","A"
13171,5,7,2,2,2,12,"B","B","B"
13176,3,3,2,2,2,6,"B","B","B"
13177,1,4,2,1,2,5,"B","A","B"
13181,10,6,2,2,1,16,"B","B","A"
13182,4,16,2,2,2,20,"B","B","B"
13183,1,3,2,2,2,4,"B","B","B"
13185,0,4,2,1,1,4,"B","A","A"
13186,1,0,1,1,2,1,"A","A","B"
13187,21,7,1,1,1,28,"A","A","A"
13189,9,3,2,1,1,12,"B","A","A"
13190,10,2,2,1,1,12,"B","A","A"
13193,6,5,1,2,2,11,"A","B","B"
13194,0,0,1,2,1,0,"A","B","A"
13202,4,5,2,2,2,9,"B","B","B"
13206,9,18,2,2,2,27,"B","B","B"
13207,4,12,2,2,2,16,"B","B","B"
13214,2,1,1,1,1,3,"A","A","A"
13223,2,7,2,2,2,9,"B","B","B"
13224,1,3,2,2,2,4,"B","B","B"
13225,0,4,2,2,2,4,"B","B","B"
13226,7,8,1,2,1,15,"A","B","A"
13227,3,0,1,2,1,3,"A","B","A"
13228,6,0,1,2,1,6,"A","B","A"
13229,7,3,2,2,1,10,"B","B","A"
13249,5,6,1,2,2,11,"A","B","B"
13266,3,7,2,2,1,10,"B","B","A"
13268,2,1,1,2,1,3,"A","B","A"
13277,10,4,1,1,2,14,"A","A","B"
13279,9,3,1,1,2,12,"A","A","B"
13282,36,5,1,2,1,41,"A","B","A"
13283,1,3,2,1,2,4,"B","A","B"
13284,5,0,1,1,2,5,"A","A","B"
13288,12,4,1,2,2,16,"A","B","B"
13289,3,6,2,2,2,9,"B","B","B"
13290,2,2,2,2,1,4,"B","B","A"
13291,4,5,2,1,2,9,"B","A","B"
13292,16,5,1,1,1,21,"A","A","A"
13293,20,12,1,1,1,32,"A","A","A"
13294,5,2,2,1,1,7,"B","A","A"
13299,5,2,1,1,2,7,"A","A","B"
13305,1,0,2,1,2,1,"B","A","B"
13307,3,8,2,2,1,11,"B","B","A"
13308,5,2,2,2,1,7,"B","B","A"
13309,3,2,2,1,1,5,"B","A","A"
13310,5,2,2,1,1,7,"B","A","A"
13311,0,1,2,2,2,1,"B","B","B"
13312,0,3,2,1,2,3,"B","A","B"
13317,0,2,1,2,2,2,"A","B","B"
13318,7,0,1,1,1,7,"A","A","A"
13319,0,0,1,1,2,0,"A","A","B"
13320,16,14,1,2,2,30,"A","B","B"
13322,3,1,1,1,1,4,"A","A","A"
13377,7,2,2,2,2,9,"B","B","B"
13382,1,2,2,1,1,3,"B","A","A"
13383,3,5,2,2,1,8,"B","B","A"
13384,3,2,1,1,2,5,"A","A","B"
13391,6,2,1,1,1,8,"A","A","A"
13398,9,11,2,1,2,20,"B","A","B"
13486,6,9,1,1,2,15,"A","A","B"
13487,2,9,2,2,2,11,"B","B","B"
13488,7,1,2,1,2,8,"B","A","B"
13490,6,0,1,1,1,6,"A","A","A"
13492,1,1,2,1,1,2,"B","A","A"
13507,0,0,2,2,1,0,"B","B","A"
13512,0,0,2,2,2,0,"B","B","B"
13513,10,1,2,1,1,11,"B","A","A"
13514,3,0,2,2,1,3,"B","B","A"
13528,2,4,2,2,2,6,"B","B","B"
13530,0,2,1,1,2,2,"A","A","B"
13532,0,0,2,2,2,0,"B","B","B"
13537,7,3,2,1,2,10,"B","A","B"
13538,14,2,1,1,1,16,"A","A","A"
13539,10,2,2,1,1,12,"B","A","A"
13542,0,0,2,1,1,0,"B","A","A"
13549,11,7,1,1,2,18,"A","A","B"
13551,15,5,1,1,1,20,"A","A","A"
13555,10,4,2,2,1,14,"B","B","A"
13558,7,8,2,1,2,15,"B","A","B"
13559,4,3,1,2,2,7,"A","B","B"
13562,5,3,2,1,2,8,"B","A","B"
13563,2,4,2,2,2,6,"B","B","B"
13564,16,4,2,1,1,20,"B","A","A"
13567,11,2,1,1,2,13,"A","A","B"
13574,6,6,2,1,2,12,"B","A","B"
13579,12,11,1,2,2,23,"A","B","B"
13583,13,3,1,2,2,16,"A","B","B"
13613,11,1,2,1,1,12,"B","A","A"
13645,6,0,1,1,2,6,"A","A","B"
13646,5,2,1,2,1,7,"A","B","A"
13647,3,4,2,1,2,7,"B","A","B"
13648,2,0,1,1,1,2,"A","A","A"
13649,21,7,2,1,2,28,"B","A","B"
13650,12,5,2,2,1,17,"B","B","A"
13651,20,7,1,2,1,27,"A","B","A"
13652,6,4,2,2,2,10,"B","B","B"
13653,9,2,1,2,1,11,"A","B","A"
13654,17,0,1,2,1,17,"A","B","A"
13655,7,5,2,1,2,12,"B","A","B"
13739,6,0,1,1,1,6,"A","A","A"
13747,8,0,1,1,2,8,"A","A","B"
13755,8,2,2,2,1,10,"B","B","A"
13756,14,0,1,1,2,14,"A","A","B"
13757,7,10,2,2,2,17,"B","B","B"
13775,5,2,2,2,2,7,"B","B","B"
13776,9,4,2,1,2,13,"B","A","B"
13778,7,2,1,1,1,9,"A","A","A"
13814,10,2,1,1,1,12,"A","A","A"
13830,14,1,1,2,1,15,"A","B","A"
13843,5,4,1,1,1,9,"A","A","A"
13848,4,0,2,1,2,4,"B","A","B"
13858,6,0,1,1,2,6,"A","A","B"
13863,2,0,1,2,1,2,"A","B","A"
13865,2,0,1,1,1,2,"A","A","A"
13881,2,1,2,2,2,3,"B","B","B"
13885,3,1,2,1,2,4,"B","A","B"
13886,10,3,1,2,1,13,"A","B","A"
13887,5,2,1,1,2,7,"A","A","B"
13906,6,2,2,2,1,8,"B","B","A"
13914,1,0,1,1,1,1,"A","A","A"
13923,0,1,1,1,2,1,"A","A","B"
13981,0,2,2,1,2,2,"B","A","B"
13982,3,3,2,1,2,6,"B","A","B"
13983,6,1,2,1,1,7,"B","A","A"
13995,4,0,2,1,1,4,"B","A","A"
14003,0,7,2,2,2,7,"B","B","B"
14004,1,3,2,2,2,4,"B","B","B"
14008,2,0,2,1,1,2,"B","A","A"
14018,9,0,1,1,1,9,"A","A","A"
14019,5,5,2,2,1,10,"B","B","A"
14024,4,0,2,1,1,4,"B","A","A"
14037,9,4,1,2,1,13,"A","B","A"
14040,4,1,1,2,1,5,"A","B","A"
14042,0,2,2,2,1,2,"B","B","A"
14043,1,0,2,2,2,1,"B","B","B"
14044,10,2,2,1,1,12,"B","A","A"
14054,9,0,2,1,1,9,"B","A","A"
14056,2,10,1,2,2,12,"A","B","B"
14057,6,3,1,2,1,9,"A","B","A"
14155,2,2,1,2,2,4,"A","B","B"
